300
0 0 0 0 0 0 0 0 0 0
0 0 0 0 0 0 0 0 0 0
0 0 0 0 R 0 0 0 0 0
0 0 0 R Y R 0 0 0 0
0 0 R Y Y Y R 0 0 0
0 R Y R G R Y R 0 0
0 Y Y Y Y Y Y Y R 0
R R R R R R R R R R
0 0 0 0 0 0 0 0 0 0
