600
0 0 0 0 0 Y 0 0 0 0
0 0 0 0 Y Y Y 0 0 0
0 0 0 Y R R R Y 0 0
0 Y Y R R R R R Y 0
R Y R R R G R R Y R
0 Y R R G R R R Y 0
0 Y Y Y Y Y Y Y Y 0
0 0 0 Y Y Y Y 0 0 0
0 0 0 Y Y Y Y 0 0 0